20%20%
ww................ww
www..............www
.w.......w........w.
.........wwww..wwww.
............w..w....
............wwww....
.......w............
......w.............
......w.............
......w.............
......www...........
........w...........
........w...........
........w...........
....................
....................
....................
.w................w.
www..............www
ww................ww
